AAACCCATCAAACACT	AAACCCAAGAAACACT
AAACCCATCAAACCAT	AAACCCAAGAAACCAT
AAACCCATCAAACCCA	AAACCCAAGAAACCCA
AAACCCATCAAACCCG	AAACCCAAGAAACCCG
AAACCCATCAAACCTG	AAACCCAAGAAACCTG
AAACCCATCAAACGAA	AAACCCAAGAAACGAA
AAACCCATCAAACGTC	AAACCCAAGAAACGTC
AAACCCATCAAACTAC	AAACCCAAGAAACTAC
AAACCCATCAAACTCA	AAACCCAAGAAACTCA
AAACCCATCAAACTGC	AAACCCAAGAAACTGC
AAACCCATCAAACTGT	AAACCCAAGAAACTGT
AAACCCATCAAAGAAC	AAACCCAAGAAAGAAC
AAACCCATCAAAGACA	AAACCCAAGAAAGACA
AAACCCATCAAAGCCT	AAACCCAAGAAAGCCT
AAACCCATCAAAGCGA	AAACCCAAGAAAGCGA
AAACCCATCAAAGGAT	AAACCCAAGAAAGGAT
AAACCCATCAAAGGTA	AAACCCAAGAAAGGTA
AAACCCATCAAAGTCT	AAACCCAAGAAAGTCT
AAACCCATCAAATAGG	AAACCCAAGAAATAGG
AAACCCATCAAATCCA	AAACCCAAGAAATCCA
AAACCCATCAAATGAG	AAACCCAAGAAATGAG
AAACCCATCAAATGCC	AAACCCAAGAAATGCC
AAACCCATCAAATGGG	AAACCCAAGAAATGGG
AAACCCATCAAATTCG	AAACCCAAGAAATTCG
AAACCCATCAAATTGC	AAACCCAAGAAATTGC
AAACCCATCAACAAGG	AAACCCAAGAACAAGG
AAACCCATCAACACCA	AAACCCAAGAACACCA
AAACCCATCAACACGT	AAACCCAAGAACACGT
AAACCCATCAACAGGA	AAACCCAAGAACAGGA
AAACCCATCAACCCGA	AAACCCAAGAACCCGA
AAACCCATCAACCCGG	AAACCCAAGAACCCGG
AAACCCATCAACCGAT	AAACCCAAGAACCGAT
AAACCCATCAACCGCA	AAACCCAAGAACCGCA
AAACCCATCAACCTCC	AAACCCAAGAACCTCC
AAACCCATCAACCTTT	AAACCCAAGAACCTTT
AAACCCATCAACGAGG	AAACCCAAGAACGAGG
AAACCCATCAACGCGT	AAACCCAAGAACGCGT
AAACCCATCAACGCTA	AAACCCAAGAACGCTA
AAACCCATCAACGTGC	AAACCCAAGAACGTGC
AAACCCATCAACGTGT	AAACCCAAGAACGTGT
AAACCCATCAACTACG	AAACCCAAGAACTACG
AAACCCATCAACTCCT	AAACCCAAGAACTCCT
AAACCCATCAACTCTT	AAACCCAAGAACTCTT
AAACCCATCAACTGAC	AAACCCAAGAACTGAC
AAACCCATCAACTGAT	AAACCCAAGAACTGAT
AAACCCATCAACTGGT	AAACCCAAGAACTGGT
AAACCCATCAACTTCC	AAACCCAAGAACTTCC
AAACCCATCAACTTTC	AAACCCAAGAACTTTC
AAACCCATCAAGAAAC	AAACCCAAGAAGAAAC
AAACCCATCAAGAACG	AAACCCAAGAAGAACG
AAACCCATCAAGAATG	AAACCCAAGAAGAATG
AAACCCATCAAGAGCA	AAACCCAAGAAGAGCA
AAACCCATCAAGAGGC	AAACCCAAGAAGAGGC
AAACCCATCAAGAGTA	AAACCCAAGAAGAGTA
AAACCCATCAAGATAG	AAACCCAAGAAGATAG
AAACCCATCAAGATCT	AAACCCAAGAAGATCT
AAACCCATCAAGCCAC	AAACCCAAGAAGCCAC
AAACCCATCAAGCCAT	AAACCCAAGAAGCCAT
AAACCCATCAAGCCCG	AAACCCAAGAAGCCCG
AAACCCATCAAGCCGC	AAACCCAAGAAGCCGC
AAACCCATCAAGCCTA	AAACCCAAGAAGCCTA
AAACCCATCAAGCCTG	AAACCCAAGAAGCCTG
AAACCCATCAAGCGAA	AAACCCAAGAAGCGAA
AAACCCATCAAGCGCT	AAACCCAAGAAGCGCT
AAACCCATCAAGCGGG	AAACCCAAGAAGCGGG
AAACCCATCAAGCGTT	AAACCCAAGAAGCGTT
AAACCCATCAAGCTCG	AAACCCAAGAAGCTCG
AAACCCATCAAGCTGC	AAACCCAAGAAGCTGC
AAACCCATCAAGCTGT	AAACCCAAGAAGCTGT
AAACCCATCAAGCTTG	AAACCCAAGAAGCTTG
AAACCCATCAAGGACG	AAACCCAAGAAGGACG
AAACCCATCAAGGAGC	AAACCCAAGAAGGAGC
AAACCCATCAAGGATG	AAACCCAAGAAGGATG
AAACCCATCAAGGCTC	AAACCCAAGAAGGCTC
AAACCCATCAAGGCTT	AAACCCAAGAAGGCTT
AAACCCATCAAGGGAT	AAACCCAAGAAGGGAT
AAACCCATCAAGGTAG	AAACCCAAGAAGGTAG
AAACCCATCAAGGTGG	AAACCCAAGAAGGTGG
AAACCCATCAAGTAAG	AAACCCAAGAAGTAAG
AAACCCATCAAGTATC	AAACCCAAGAAGTATC
AAACCCATCAAGTCAT	AAACCCAAGAAGTCAT
AAACCCATCAAGTCCG	AAACCCAAGAAGTCCG
AAACCCATCAAGTCGT	AAACCCAAGAAGTCGT
AAACCCATCAAGTCTA	AAACCCAAGAAGTCTA
AAACCCATCAAGTCTG	AAACCCAAGAAGTCTG
AAACCCATCAAGTGGG	AAACCCAAGAAGTGGG
AAACCCATCAAGTGTC	AAACCCAAGAAGTGTC
AAACCCATCAAGTGTT	AAACCCAAGAAGTGTT
AAACCCATCAAGTTGC	AAACCCAAGAAGTTGC
AAACCCATCAATAACC	AAACCCAAGAATAACC
AAACCCATCAATACAC	AAACCCAAGAATACAC
AAACCCATCAATAGTC	AAACCCAAGAATAGTC
AAACCCATCAATCAGC	AAACCCAAGAATCAGC
AAACCCATCAATCCAG	AAACCCAAGAATCCAG
AAACCCATCAATCCCT	AAACCCAAGAATCCCT
AAACCCATCAATCCGA	AAACCCAAGAATCCGA
AAACCCATCAATCGAT	AAACCCAAGAATCGAT
AAACCCATCAATCGCG	AAACCCAAGAATCGCG
AAACCCATCAATCGGT	AAACCCAAGAATCGGT
AAACCCATCAATCGTA	AAACCCAAGAATCGTA
AAACCCATCAATCTAG	AAACCCAAGAATCTAG
AAACCCATCAATCTCT	AAACCCAAGAATCTCT
AAACCCATCAATCTTC	AAACCCAAGAATCTTC
AAACCCATCAATGCAC	AAACCCAAGAATGCAC
AAACCCATCAATGTCG	AAACCCAAGAATGTCG
AAACCCATCAATGTTG	AAACCCAAGAATGTTG
AAACCCATCAATTCAG	AAACCCAAGAATTCAG
AAACCCATCAATTGCA	AAACCCAAGAATTGCA
AAACCCATCAATTGTG	AAACCCAAGAATTGTG
AAACCCATCAATTTGG	AAACCCAAGAATTTGG
AAACCCATCACAACAT	AAACCCAAGACAACAT
AAACCCATCACAACCA	AAACCCAAGACAACCA
AAACCCATCACAACTA	AAACCCAAGACAACTA
AAACCCATCACAAGAA	AAACCCAAGACAAGAA
AAACCCATCACAAGCC	AAACCCAAGACAAGCC
AAACCCATCACAAGGG	AAACCCAAGACAAGGG
AAACCCATCACAATGC	AAACCCAAGACAATGC
AAACCCATCACACACG	AAACCCAAGACACACG
AAACCCATCACACCCT	AAACCCAAGACACCCT
AAACCCATCACACCGG	AAACCCAAGACACCGG
AAACCCATCACACGAT	AAACCCAAGACACGAT
AAACCCATCACAGAGG	AAACCCAAGACAGAGG
AAACCCATCACAGCGT	AAACCCAAGACAGCGT
AAACCCATCACAGCTG	AAACCCAAGACAGCTG
AAACCCATCACAGTCG	AAACCCAAGACAGTCG
AAACCCATCACAGTGT	AAACCCAAGACAGTGT
AAACCCATCACATAAC	AAACCCAAGACATAAC
AAACCCATCACATACA	AAACCCAAGACATACA
AAACCCATCACATACG	AAACCCAAGACATACG
AAACCCATCACATAGT	AAACCCAAGACATAGT
AAACCCATCACATATG	AAACCCAAGACATATG
AAACCCATCACATCAA	AAACCCAAGACATCAA
AAACCCATCACATCAG	AAACCCAAGACATCAG
AAACCCATCACATCCT	AAACCCAAGACATCCT
AAACCCATCACATGCG	AAACCCAAGACATGCG
AAACCCATCACATTGG	AAACCCAAGACATTGG
AAACCCATCACCAAAT	AAACCCAAGACCAAAT
AAACCCATCACCAACG	AAACCCAAGACCAACG
AAACCCATCACCAAGC	AAACCCAAGACCAAGC
AAACCCATCACCACAA	AAACCCAAGACCACAA
AAACCCATCACCACGA	AAACCCAAGACCACGA
AAACCCATCACCAGAC	AAACCCAAGACCAGAC
AAACCCATCACCAGCA	AAACCCAAGACCAGCA
AAACCCATCACCATAA	AAACCCAAGACCATAA
AAACCCATCACCATAG	AAACCCAAGACCATAG
AAACCCATCACCATCC	AAACCCAAGACCATCC
AAACCCATCACCATGA	AAACCCAAGACCATGA
AAACCCATCACCATGG	AAACCCAAGACCATGG
AAACCCATCACCATTC	AAACCCAAGACCATTC
AAACCCATCACCCATC	AAACCCAAGACCCATC
AAACCCATCACCCGCT	AAACCCAAGACCCGCT
AAACCCATCACCCTCA	AAACCCAAGACCCTCA
AAACCCATCACCCTGT	AAACCCAAGACCCTGT
AAACCCATCACCCTTA	AAACCCAAGACCCTTA
AAACCCATCACCCTTG	AAACCCAAGACCCTTG
AAACCCATCACCGACG	AAACCCAAGACCGACG
AAACCCATCACCGCCT	AAACCCAAGACCGCCT
AAACCCATCACCGCTT	AAACCCAAGACCGCTT
AAACCCATCACCGGGT	AAACCCAAGACCGGGT
AAACCCATCACCGGTG	AAACCCAAGACCGGTG
AAACCCATCACCGTTT	AAACCCAAGACCGTTT
AAACCCATCACCTACC	AAACCCAAGACCTACC
AAACCCATCACCTCAC	AAACCCAAGACCTCAC
AAACCCATCACCTCAT	AAACCCAAGACCTCAT
AAACCCATCACCTCCG	AAACCCAAGACCTCCG
AAACCCATCACCTCGT	AAACCCAAGACCTCGT
AAACCCATCACCTCTG	AAACCCAAGACCTCTG
AAACCCATCACCTGGA	AAACCCAAGACCTGGA
AAACCCATCACCTGGG	AAACCCAAGACCTGGG
AAACCCATCACCTGTC	AAACCCAAGACCTGTC
AAACCCATCACCTTAT	AAACCCAAGACCTTAT
AAACCCATCACCTTGC	AAACCCAAGACCTTGC
AAACCCATCACCTTTG	AAACCCAAGACCTTTG
AAACCCATCACGAACT	AAACCCAAGACGAACT
AAACCCATCACGAAGA	AAACCCAAGACGAAGA
AAACCCATCACGACGT	AAACCCAAGACGACGT
AAACCCATCACGACTA	AAACCCAAGACGACTA
AAACCCATCACGACTG	AAACCCAAGACGACTG
AAACCCATCACGAGCT	AAACCCAAGACGAGCT
AAACCCATCACGAGGA	AAACCCAAGACGAGGA
AAACCCATCACGATAC	AAACCCAAGACGATAC
AAACCCATCACGATAT	AAACCCAAGACGATAT
AAACCCATCACGATCA	AAACCCAAGACGATCA
AAACCCATCACGCAGT	AAACCCAAGACGCAGT
AAACCCATCACGCATG	AAACCCAAGACGCATG
AAACCCATCACGCCAA	AAACCCAAGACGCCAA
AAACCCATCACGCCCT	AAACCCAAGACGCCCT
AAACCCATCACGCTCC	AAACCCAAGACGCTCC
AAACCCATCACGGAAA	AAACCCAAGACGGAAA
AAACCCATCACGGACC	AAACCCAAGACGGACC
AAACCCATCACGGAGA	AAACCCAAGACGGAGA
AAACCCATCACGGATC	AAACCCAAGACGGATC
AAACCCATCACGGGAA	AAACCCAAGACGGGAA
AAACCCATCACGGGCT	AAACCCAAGACGGGCT
AAACCCATCACGGTCA	AAACCCAAGACGGTCA
AAACCCATCACGGTCG	AAACCCAAGACGGTCG
AAACCCATCACGGTTG	AAACCCAAGACGGTTG
AAACCCATCACGTAGT	AAACCCAAGACGTAGT
AAACCCATCACGTCCC	AAACCCAAGACGTCCC
AAACCCATCACGTCCT	AAACCCAAGACGTCCT
AAACCCATCACGTCGA	AAACCCAAGACGTCGA
AAACCCATCACTAAGT	AAACCCAAGACTAAGT
AAACCCATCACTACCT	AAACCCAAGACTACCT
AAACCCATCACTACGA	AAACCCAAGACTACGA
AAACCCATCACTACGG	AAACCCAAGACTACGG
AAACCCATCACTACTT	AAACCCAAGACTACTT
AAACCCATCACTAGAT	AAACCCAAGACTAGAT
AAACCCATCACTAGCA	AAACCCAAGACTAGCA
AAACCCATCACTCAAA	AAACCCAAGACTCAAA
AAACCCATCACTCACC	AAACCCAAGACTCACC
AAACCCATCACTCATC	AAACCCAAGACTCATC
AAACCCATCACTCCGC	AAACCCAAGACTCCGC
AAACCCATCACTCCGT	AAACCCAAGACTCCGT
AAACCCATCACTCGAA	AAACCCAAGACTCGAA
AAACCCATCACTCGAG	AAACCCAAGACTCGAG
AAACCCATCACTCTAC	AAACCCAAGACTCTAC
AAACCCATCACTCTTA	AAACCCAAGACTCTTA
AAACCCATCACTCTTG	AAACCCAAGACTCTTG
AAACCCATCACTGAAC	AAACCCAAGACTGAAC
AAACCCATCACTGAGC	AAACCCAAGACTGAGC
AAACCCATCACTGATG	AAACCCAAGACTGATG
AAACCCATCACTGCTC	AAACCCAAGACTGCTC
AAACCCATCACTGGGC	AAACCCAAGACTGGGC
AAACCCATCACTGGGT	AAACCCAAGACTGGGT
AAACCCATCACTGGTA	AAACCCAAGACTGGTA
AAACCCATCACTGTCC	AAACCCAAGACTGTCC
AAACCCATCACTGTTC	AAACCCAAGACTGTTC
AAACCCATCACTGTTT	AAACCCAAGACTGTTT
AAACCCATCACTTAAG	AAACCCAAGACTTAAG
AAACCCATCACTTATC	AAACCCAAGACTTATC
AAACCCATCACTTCAC	AAACCCAAGACTTCAC
AAACCCATCACTTCCA	AAACCCAAGACTTCCA
AAACCCATCACTTCGT	AAACCCAAGACTTCGT
AAACCCATCACTTCTA	AAACCCAAGACTTCTA
AAACCCATCACTTGGA	AAACCCAAGACTTGGA
AAACCCATCACTTGTC	AAACCCAAGACTTGTC
AAACCCATCACTTGTT	AAACCCAAGACTTGTT
AAACCCATCACTTTGT	AAACCCAAGACTTTGT
AAACCCATCAGAACCC	AAACCCAAGAGAACCC
AAACCCATCAGAACCT	AAACCCAAGAGAACCT
AAACCCATCAGAAGGT	AAACCCAAGAGAAGGT
AAACCCATCAGAATAG	AAACCCAAGAGAATAG
AAACCCATCAGAATCT	AAACCCAAGAGAATCT
AAACCCATCAGACAAA	AAACCCAAGAGACAAA
AAACCCATCAGACAAG	AAACCCAAGAGACAAG
AAACCCATCAGACATC	AAACCCAAGAGACATC
AAACCCATCAGACCCG	AAACCCAAGAGACCCG
AAACCCATCAGACCGC	AAACCCAAGAGACCGC
AAACCCATCAGACCTA	AAACCCAAGAGACCTA
AAACCCATCAGACTGT	AAACCCAAGAGACTGT
AAACCCATCAGAGAAC	AAACCCAAGAGAGAAC
AAACCCATCAGAGCAA	AAACCCAAGAGAGCAA
AAACCCATCAGAGCAG	AAACCCAAGAGAGCAG
AAACCCATCAGAGCCT	AAACCCAAGAGAGCCT
AAACCCATCAGAGCGA	AAACCCAAGAGAGCGA
AAACCCATCAGAGCGG	AAACCCAAGAGAGCGG
AAACCCATCAGAGGGC	AAACCCAAGAGAGGGC
AAACCCATCAGAGGTA	AAACCCAAGAGAGGTA
AAACCCATCAGAGTGA	AAACCCAAGAGAGTGA
AAACCCATCAGAGTGG	AAACCCAAGAGAGTGG
AAACCCATCAGAGTTC	AAACCCAAGAGAGTTC
AAACCCATCAGAGTTT	AAACCCAAGAGAGTTT
AAACCCATCAGATCGC	AAACCCAAGAGATCGC
AAACCCATCAGATGCC	AAACCCAAGAGATGCC
AAACCCATCAGATGCT	AAACCCAAGAGATGCT
AAACCCATCAGATTCA	AAACCCAAGAGATTCA
AAACCCATCAGATTGC	AAACCCAAGAGATTGC
AAACCCATCAGCAACC	AAACCCAAGAGCAACC
AAACCCATCAGCAAGA	AAACCCAAGAGCAAGA
AAACCCATCAGCAATC	AAACCCAAGAGCAATC
AAACCCATCAGCACCG	AAACCCAAGAGCACCG
AAACCCATCAGCACTG	AAACCCAAGAGCACTG
AAACCCATCAGCAGAA	AAACCCAAGAGCAGAA
AAACCCATCAGCAGAG	AAACCCAAGAGCAGAG
AAACCCATCAGCAGCT	AAACCCAAGAGCAGCT
AAACCCATCAGCAGTC	AAACCCAAGAGCAGTC
AAACCCATCAGCATAT	AAACCCAAGAGCATAT
AAACCCATCAGCATCG	AAACCCAAGAGCATCG
AAACCCATCAGCATTA	AAACCCAAGAGCATTA
AAACCCATCAGCATTG	AAACCCAAGAGCATTG
AAACCCATCAGCCATG	AAACCCAAGAGCCATG
AAACCCATCAGCCCAA	AAACCCAAGAGCCCAA
AAACCCATCAGCCCAG	AAACCCAAGAGCCCAG
AAACCCATCAGCCGAT	AAACCCAAGAGCCGAT
AAACCCATCAGCCGTA	AAACCCAAGAGCCGTA
AAACCCATCAGCCTCT	AAACCCAAGAGCCTCT
AAACCCATCAGCCTGA	AAACCCAAGAGCCTGA
AAACCCATCAGCCTTC	AAACCCAAGAGCCTTC
AAACCCATCAGCGACT	AAACCCAAGAGCGACT
AAACCCATCAGCGCAC	AAACCCAAGAGCGCAC
AAACCCATCAGCGCGT	AAACCCAAGAGCGCGT
AAACCCATCAGCGGAA	AAACCCAAGAGCGGAA
AAACCCATCAGCGTCG	AAACCCAAGAGCGTCG
AAACCCATCAGCTAGT	AAACCCAAGAGCTAGT
AAACCCATCAGCTCTC	AAACCCAAGAGCTCTC
AAACCCATCAGCTGAC	AAACCCAAGAGCTGAC
AAACCCATCAGCTGAT	AAACCCAAGAGCTGAT
AAACCCATCAGCTGCA	AAACCCAAGAGCTGCA
AAACCCATCAGCTGTA	AAACCCAAGAGCTGTA
AAACCCATCAGCTTCC	AAACCCAAGAGCTTCC
AAACCCATCAGCTTGA	AAACCCAAGAGCTTGA
AAACCCATCAGCTTTC	AAACCCAAGAGCTTTC
AAACCCATCAGGAAAT	AAACCCAAGAGGAAAT
AAACCCATCAGGAACG	AAACCCAAGAGGAACG
AAACCCATCAGGAAGC	AAACCCAAGAGGAAGC
AAACCCATCAGGACAG	AAACCCAAGAGGACAG
AAACCCATCAGGACGA	AAACCCAAGAGGACGA
AAACCCATCAGGACTC	AAACCCAAGAGGACTC
AAACCCATCAGGAGAC	AAACCCAAGAGGAGAC
AAACCCATCAGGATCC	AAACCCAAGAGGATCC
AAACCCATCAGGATGA	AAACCCAAGAGGATGA
AAACCCATCAGGCCAT	AAACCCAAGAGGCCAT
AAACCCATCAGGCGAA	AAACCCAAGAGGCGAA
AAACCCATCAGGCGGA	AAACCCAAGAGGCGGA
AAACCCATCAGGCGTT	AAACCCAAGAGGCGTT
AAACCCATCAGGCTGT	AAACCCAAGAGGCTGT
AAACCCATCAGGGATG	AAACCCAAGAGGGATG
AAACCCATCAGGGCGA	AAACCCAAGAGGGCGA
AAACCCATCAGGGTAA	AAACCCAAGAGGGTAA
AAACCCATCAGGGTAG	AAACCCAAGAGGGTAG
AAACCCATCAGGGTCT	AAACCCAAGAGGGTCT
AAACCCATCAGGGTGG	AAACCCAAGAGGGTGG
AAACCCATCAGGTAAA	AAACCCAAGAGGTAAA
AAACCCATCAGGTATT	AAACCCAAGAGGTATT
AAACCCATCAGGTCAC	AAACCCAAGAGGTCAC
AAACCCATCAGGTCGT	AAACCCAAGAGGTCGT
AAACCCATCAGGTGCT	AAACCCAAGAGGTGCT
AAACCCATCAGGTGTT	AAACCCAAGAGGTGTT
AAACCCATCAGGTTAT	AAACCCAAGAGGTTAT
AAACCCATCAGGTTTA	AAACCCAAGAGGTTTA
AAACCCATCAGTAACT	AAACCCAAGAGTAACT
AAACCCATCAGTACCG	AAACCCAAGAGTACCG
AAACCCATCAGTAGGG	AAACCCAAGAGTAGGG
AAACCCATCAGTATAC	AAACCCAAGAGTATAC
AAACCCATCAGTCAAT	AAACCCAAGAGTCAAT
AAACCCATCAGTCACA	AAACCCAAGAGTCACA
AAACCCATCAGTCACG	AAACCCAAGAGTCACG
AAACCCATCAGTCAGC	AAACCCAAGAGTCAGC
AAACCCATCAGTCAGT	AAACCCAAGAGTCAGT
AAACCCATCAGTCATG	AAACCCAAGAGTCATG
AAACCCATCAGTCCGA	AAACCCAAGAGTCCGA
AAACCCATCAGTCCGG	AAACCCAAGAGTCCGG
AAACCCATCAGTCGAC	AAACCCAAGAGTCGAC
AAACCCATCAGTCTGG	AAACCCAAGAGTCTGG
AAACCCATCAGTCTTC	AAACCCAAGAGTCTTC
AAACCCATCAGTCTTT	AAACCCAAGAGTCTTT
AAACCCATCAGTGAAG	AAACCCAAGAGTGAAG
AAACCCATCAGTGACC	AAACCCAAGAGTGACC
AAACCCATCAGTGATC	AAACCCAAGAGTGATC
AAACCCATCAGTGCGC	AAACCCAAGAGTGCGC
AAACCCATCAGTGGCT	AAACCCAAGAGTGGCT
AAACCCATCAGTGGGA	AAACCCAAGAGTGGGA
AAACCCATCAGTGTCA	AAACCCAAGAGTGTCA
AAACCCATCAGTGTGC	AAACCCAAGAGTGTGC
AAACCCATCAGTGTGT	AAACCCAAGAGTGTGT
AAACCCATCAGTGTTA	AAACCCAAGAGTGTTA
AAACCCATCAGTGTTG	AAACCCAAGAGTGTTG
AAACCCATCAGTTCGG	AAACCCAAGAGTTCGG
AAACCCATCAGTTGAT	AAACCCAAGAGTTGAT
AAACCCATCAGTTGCG	AAACCCAAGAGTTGCG
AAACCCATCAGTTGTA	AAACCCAAGAGTTGTA
AAACCCATCATAACAC	AAACCCAAGATAACAC
AAACCCATCATAACGT	AAACCCAAGATAACGT
AAACCCATCATAAGGA	AAACCCAAGATAAGGA
AAACCCATCATACAGC	AAACCCAAGATACAGC
AAACCCATCATACAGT	AAACCCAAGATACAGT
AAACCCATCATACATG	AAACCCAAGATACATG
AAACCCATCATACCAA	AAACCCAAGATACCAA
AAACCCATCATACGAC	AAACCCAAGATACGAC
AAACCCATCATACGAT	AAACCCAAGATACGAT
AAACCCATCATACGGT	AAACCCAAGATACGGT
AAACCCATCATACTGA	AAACCCAAGATACTGA
AAACCCATCATAGACC	AAACCCAAGATAGACC
AAACCCATCATAGAGA	AAACCCAAGATAGAGA
AAACCCATCATAGCAC	AAACCCAAGATAGCAC
AAACCCATCATAGCAT	AAACCCAAGATAGCAT
AAACCCATCATAGCTA	AAACCCAAGATAGCTA
AAACCCATCATAGGCT	AAACCCAAGATAGGCT
AAACCCATCATAGGGA	AAACCCAAGATAGGGA
AAACCCATCATAGTCA	AAACCCAAGATAGTCA
AAACCCATCATAGTGT	AAACCCAAGATAGTGT
AAACCCATCATATGGC	AAACCCAAGATATGGC
AAACCCATCATCACAG	AAACCCAAGATCACAG
AAACCCATCATCACCC	AAACCCAAGATCACCC
AAACCCATCATCACCT	AAACCCAAGATCACCT
AAACCCATCATCACTC	AAACCCAAGATCACTC
AAACCCATCATCACTT	AAACCCAAGATCACTT
AAACCCATCATCAGTG	AAACCCAAGATCAGTG
AAACCCATCATCCAAA	AAACCCAAGATCCAAA
AAACCCATCATCCCAT	AAACCCAAGATCCCAT
AAACCCATCATCCCGC	AAACCCAAGATCCCGC
AAACCCATCATCCCGT	AAACCCAAGATCCCGT
AAACCCATCATCCGAG	AAACCCAAGATCCGAG
AAACCCATCATCCTAC	AAACCCAAGATCCTAC
AAACCCATCATCCTAT	AAACCCAAGATCCTAT
AAACCCATCATCCTGC	AAACCCAAGATCCTGC
AAACCCATCATCGACA	AAACCCAAGATCGACA
AAACCCATCATCGACG	AAACCCAAGATCGACG
AAACCCATCATCGCAA	AAACCCAAGATCGCAA
AAACCCATCATCGCCC	AAACCCAAGATCGCCC
AAACCCATCATCGCCT	AAACCCAAGATCGCCT
AAACCCATCATCGCTC	AAACCCAAGATCGCTC
AAACCCATCATCGCTT	AAACCCAAGATCGCTT
AAACCCATCATCGGGC	AAACCCAAGATCGGGC
AAACCCATCATCGGTG	AAACCCAAGATCGGTG
AAACCCATCATCGTAG	AAACCCAAGATCGTAG
AAACCCATCATCTACT	AAACCCAAGATCTACT
AAACCCATCATCTATC	AAACCCAAGATCTATC
AAACCCATCATCTCTA	AAACCCAAGATCTCTA
AAACCCATCATCTGTT	AAACCCAAGATCTGTT
AAACCCATCATGAAAG	AAACCCAAGATGAAAG
AAACCCATCATGAACT	AAACCCAAGATGAACT
AAACCCATCATGAAGG	AAACCCAAGATGAAGG
AAACCCATCATGAATC	AAACCCAAGATGAATC
AAACCCATCATGACAC	AAACCCAAGATGACAC
AAACCCATCATGACAT	AAACCCAAGATGACAT
AAACCCATCATGACCG	AAACCCAAGATGACCG
AAACCCATCATGAGAA	AAACCCAAGATGAGAA
AAACCCATCATGAGGG	AAACCCAAGATGAGGG
AAACCCATCATGAGTC	AAACCCAAGATGAGTC
AAACCCATCATGATTG	AAACCCAAGATGATTG
AAACCCATCATGCAGC	AAACCCAAGATGCAGC
AAACCCATCATGCAGT	AAACCCAAGATGCAGT
AAACCCATCATGCATG	AAACCCAAGATGCATG
AAACCCATCATGCCAA	AAACCCAAGATGCCAA
AAACCCATCATGCCCT	AAACCCAAGATGCCCT
AAACCCATCATGCCGA	AAACCCAAGATGCCGA
AAACCCATCATGCCGG	AAACCCAAGATGCCGG
AAACCCATCATGCGAC	AAACCCAAGATGCGAC
AAACCCATCATGCGGC	AAACCCAAGATGCGGC
AAACCCATCATGCTAA	AAACCCAAGATGCTAA
AAACCCATCATGCTAG	AAACCCAAGATGCTAG
AAACCCATCATGCTGG	AAACCCAAGATGCTGG
AAACCCATCATGCTTC	AAACCCAAGATGCTTC
AAACCCATCATGGAGG	AAACCCAAGATGGAGG
AAACCCATCATGGATC	AAACCCAAGATGGATC
AAACCCATCATGGCAC	AAACCCAAGATGGCAC
AAACCCATCATGGCCG	AAACCCAAGATGGCCG
AAACCCATCATGGCGT	AAACCCAAGATGGCGT
AAACCCATCATGGGAG	AAACCCAAGATGGGAG
AAACCCATCATGGGCT	AAACCCAAGATGGGCT
AAACCCATCATGGTAC	AAACCCAAGATGGTAC
AAACCCATCATGGTAT	AAACCCAAGATGGTAT
AAACCCATCATGGTCG	AAACCCAAGATGGTCG
AAACCCATCATGTAGT	AAACCCAAGATGTAGT
AAACCCATCATGTCAG	AAACCCAAGATGTCAG
AAACCCATCATGTCTT	AAACCCAAGATGTCTT
AAACCCATCATGTTAG	AAACCCAAGATGTTAG
AAACCCATCATGTTCC	AAACCCAAGATGTTCC
AAACCCATCATGTTGA	AAACCCAAGATGTTGA
AAACCCATCATTACCC	AAACCCAAGATTACCC
AAACCCATCATTACCT	AAACCCAAGATTACCT
AAACCCATCATTACGG	AAACCCAAGATTACGG
AAACCCATCATTACTC	AAACCCAAGATTACTC
AAACCCATCATTAGAC	AAACCCAAGATTAGAC
AAACCCATCATTAGCA	AAACCCAAGATTAGCA
AAACCCATCATTAGTG	AAACCCAAGATTAGTG
AAACCCATCATTATCC	AAACCCAAGATTATCC
AAACCCATCATTCACT	AAACCCAAGATTCACT
AAACCCATCATTCATC	AAACCCAAGATTCATC
AAACCCATCATTCCTA	AAACCCAAGATTCCTA
AAACCCATCATTCGAA	AAACCCAAGATTCGAA
AAACCCATCATTCGCT	AAACCCAAGATTCGCT
AAACCCATCATTCGGA	AAACCCAAGATTCGGA
AAACCCATCATTCGTT	AAACCCAAGATTCGTT
AAACCCATCATTCTTG	AAACCCAAGATTCTTG
AAACCCATCATTGACA	AAACCCAAGATTGACA
AAACCCATCATTGAGC	AAACCCAAGATTGAGC
AAACCCATCATTGAGT	AAACCCAAGATTGAGT
AAACCCATCATTGATG	AAACCCAAGATTGATG
AAACCCATCATTGCCC	AAACCCAAGATTGCCC
AAACCCATCATTGCGA	AAACCCAAGATTGCGA
AAACCCATCATTGCGG	AAACCCAAGATTGCGG
AAACCCATCATTGCTT	AAACCCAAGATTGCTT
AAACCCATCATTGGGC	AAACCCAAGATTGGGC
AAACCCATCATTGGTG	AAACCCAAGATTGGTG
AAACCCATCATTGTGA	AAACCCAAGATTGTGA
AAACCCATCATTGTGG	AAACCCAAGATTGTGG
AAACCCATCATTGTTC	AAACCCAAGATTGTTC
AAACCCATCATTTACC	AAACCCAAGATTTACC
AAACCCATCATTTCCA	AAACCCAAGATTTCCA
AAACCCATCATTTCGT	AAACCCAAGATTTCGT
AAACCCATCATTTGCC	AAACCCAAGATTTGCC
AAACCCATCATTTGCT	AAACCCAAGATTTGCT
AAACCCATCATTTGGG	AAACCCAAGATTTGGG
AAACCCATCATTTGTC	AAACCCAAGATTTGTC
AAACCCATCCAAACAT	AAACCCAAGCAAACAT
AAACCCATCCAAACCA	AAACCCAAGCAAACCA
AAACCCATCCAAAGGG	AAACCCAAGCAAAGGG
AAACCCATCCAAATCA	AAACCCAAGCAAATCA
AAACCCATCCAAATGC	AAACCCAAGCAAATGC
AAACCCATCCAAATGT	AAACCCAAGCAAATGT
AAACCCATCCAACAAT	AAACCCAAGCAACAAT
AAACCCATCCAACACA	AAACCCAAGCAACACA
AAACCCATCCAACAGC	AAACCCAAGCAACAGC
AAACCCATCCAACCAA	AAACCCAAGCAACCAA
AAACCCATCCAACCAG	AAACCCAAGCAACCAG
AAACCCATCCAACCGG	AAACCCAAGCAACCGG
AAACCCATCCAACTAG	AAACCCAAGCAACTAG
AAACCCATCCAACTCT	AAACCCAAGCAACTCT
AAACCCATCCAACTGA	AAACCCAAGCAACTGA
AAACCCATCCAACTTC	AAACCCAAGCAACTTC
AAACCCATCCAAGAGG	AAACCCAAGCAAGAGG
AAACCCATCCAAGCAT	AAACCCAAGCAAGCAT
AAACCCATCCAAGCCA	AAACCCAAGCAAGCCA
AAACCCATCCAAGCCG	AAACCCAAGCAAGCCG
AAACCCATCCAAGCTA	AAACCCAAGCAAGCTA
AAACCCATCCAAGGAA	AAACCCAAGCAAGGAA
AAACCCATCCAAGGGA	AAACCCAAGCAAGGGA
AAACCCATCCAAGTCG	AAACCCAAGCAAGTCG
AAACCCATCCAAGTGC	AAACCCAAGCAAGTGC
AAACCCATCCAATAAC	AAACCCAAGCAATAAC
AAACCCATCCAATAGT	AAACCCAAGCAATAGT
AAACCCATCCAATCCC	AAACCCAAGCAATCCC
AAACCCATCCAATCTT	AAACCCAAGCAATCTT
AAACCCATCCAATGCA	AAACCCAAGCAATGCA
AAACCCATCCAATTAG	AAACCCAAGCAATTAG
AAACCCATCCAATTCC	AAACCCAAGCAATTCC
AAACCCATCCACAAAT	AAACCCAAGCACAAAT
AAACCCATCCACAAGT	AAACCCAAGCACAAGT
AAACCCATCCACACAA	AAACCCAAGCACACAA
AAACCCATCCACACAG	AAACCCAAGCACACAG
AAACCCATCCACACCC	AAACCCAAGCACACCC
AAACCCATCCACACCT	AAACCCAAGCACACCT
AAACCCATCCACAGCG	AAACCCAAGCACAGCG
AAACCCATCCACAGGC	AAACCCAAGCACAGGC
AAACCCATCCACATAG	AAACCCAAGCACATAG
AAACCCATCCACCAGA	AAACCCAAGCACCAGA
AAACCCATCCACCCAC	AAACCCAAGCACCCAC
AAACCCATCCACCCTA	AAACCCAAGCACCCTA
AAACCCATCCACCGAA	AAACCCAAGCACCGAA
AAACCCATCCACCGTC	AAACCCAAGCACCGTC
AAACCCATCCACCTCA	AAACCCAAGCACCTCA
AAACCCATCCACCTGC	AAACCCAAGCACCTGC
AAACCCATCCACCTGT	AAACCCAAGCACCTGT
AAACCCATCCACGAAT	AAACCCAAGCACGAAT
AAACCCATCCACGATG	AAACCCAAGCACGATG
AAACCCATCCACGGAC	AAACCCAAGCACGGAC
AAACCCATCCACGGAT	AAACCCAAGCACGGAT
AAACCCATCCACGGGT	AAACCCAAGCACGGGT
AAACCCATCCACGTAA	AAACCCAAGCACGTAA
AAACCCATCCACGTCC	AAACCCAAGCACGTCC
AAACCCATCCACGTCT	AAACCCAAGCACGTCT
AAACCCATCCACGTGG	AAACCCAAGCACGTGG
AAACCCATCCACTAAA	AAACCCAAGCACTAAA
AAACCCATCCACTAGA	AAACCCAAGCACTAGA
AAACCCATCCACTAGG	AAACCCAAGCACTAGG
AAACCCATCCACTCAT	AAACCCAAGCACTCAT
AAACCCATCCACTCCG	AAACCCAAGCACTCCG
AAACCCATCCACTCGC	AAACCCAAGCACTCGC
AAACCCATCCACTCTA	AAACCCAAGCACTCTA
AAACCCATCCACTGAA	AAACCCAAGCACTGAA
AAACCCATCCACTGGA	AAACCCAAGCACTGGA
AAACCCATCCACTGGG	AAACCCAAGCACTGGG
AAACCCATCCACTTCG	AAACCCAAGCACTTCG
AAACCCATCCACTTTA	AAACCCAAGCACTTTA
AAACCCATCCACTTTG	AAACCCAAGCACTTTG
AAACCCATCCAGAAAG	AAACCCAAGCAGAAAG
AAACCCATCCAGATAT	AAACCCAAGCAGATAT
AAACCCATCCAGCAAT	AAACCCAAGCAGCAAT
AAACCCATCCAGCACA	AAACCCAAGCAGCACA
AAACCCATCCAGCACG	AAACCCAAGCAGCACG
AAACCCATCCAGCAGT	AAACCCAAGCAGCAGT
AAACCCATCCAGCCCT	AAACCCAAGCAGCCCT
AAACCCATCCAGCCTC	AAACCCAAGCAGCCTC
AAACCCATCCAGCCTT	AAACCCAAGCAGCCTT
AAACCCATCCAGCGAT	AAACCCAAGCAGCGAT
AAACCCATCCAGCTCT	AAACCCAAGCAGCTCT
AAACCCATCCAGGACC	AAACCCAAGCAGGACC
AAACCCATCCAGGCAT	AAACCCAAGCAGGCAT
AAACCCATCCAGGCTA	AAACCCAAGCAGGCTA
AAACCCATCCAGGGAG	AAACCCAAGCAGGGAG
AAACCCATCCAGGTCA	AAACCCAAGCAGGTCA
AAACCCATCCAGTAAT	AAACCCAAGCAGTAAT
AAACCCATCCAGTACA	AAACCCAAGCAGTACA
AAACCCATCCAGTACG	AAACCCAAGCAGTACG
AAACCCATCCAGTCTT	AAACCCAAGCAGTCTT
AAACCCATCCAGTGCG	AAACCCAAGCAGTGCG
AAACCCATCCAGTGTA	AAACCCAAGCAGTGTA
AAACCCATCCAGTTCC	AAACCCAAGCAGTTCC
AAACCCATCCATAAGC	AAACCCAAGCATAAGC
AAACCCATCCATACAG	AAACCCAAGCATACAG
AAACCCATCCATACTC	AAACCCAAGCATACTC
AAACCCATCCATACTT	AAACCCAAGCATACTT
AAACCCATCCATAGAC	AAACCCAAGCATAGAC
AAACCCATCCATAGGC	AAACCCAAGCATAGGC
AAACCCATCCATAGGT	AAACCCAAGCATAGGT
AAACCCATCCATATGA	AAACCCAAGCATATGA
AAACCCATCCATATGG	AAACCCAAGCATATGG
AAACCCATCCATCAAA	AAACCCAAGCATCAAA
AAACCCATCCATCACC	AAACCCAAGCATCACC
AAACCCATCCATCAGA	AAACCCAAGCATCAGA
AAACCCATCCATCAGG	AAACCCAAGCATCAGG
AAACCCATCCATCCCG	AAACCCAAGCATCCCG
AAACCCATCCATCCGT	AAACCCAAGCATCCGT
AAACCCATCCATCCTA	AAACCCAAGCATCCTA
AAACCCATCCATCGAG	AAACCCAAGCATCGAG
AAACCCATCCATCGTC	AAACCCAAGCATCGTC
AAACCCATCCATCTAT	AAACCCAAGCATCTAT
AAACCCATCCATCTCG	AAACCCAAGCATCTCG
AAACCCATCCATCTGC	AAACCCAAGCATCTGC
AAACCCATCCATCTTG	AAACCCAAGCATCTTG
AAACCCATCCATGAAT	AAACCCAAGCATGAAT
AAACCCATCCATGAGT	AAACCCAAGCATGAGT
AAACCCATCCATGATA	AAACCCAAGCATGATA
AAACCCATCCATGATG	AAACCCAAGCATGATG
AAACCCATCCATGCAA	AAACCCAAGCATGCAA
AAACCCATCCATGCAG	AAACCCAAGCATGCAG
AAACCCATCCATGCGA	AAACCCAAGCATGCGA
AAACCCATCCATGGGT	AAACCCAAGCATGGGT
AAACCCATCCATGTTC	AAACCCAAGCATGTTC
AAACCCATCCATTCAT	AAACCCAAGCATTCAT
AAACCCATCCATTCGC	AAACCCAAGCATTCGC
AAACCCATCCATTGAA	AAACCCAAGCATTGAA
AAACCCATCCATTGCC	AAACCCAAGCATTGCC
AAACCCATCCATTGGA	AAACCCAAGCATTGGA
AAACCCATCCATTGTC	AAACCCAAGCATTGTC
AAACCCATCCATTGTT	AAACCCAAGCATTGTT
AAACCCATCCATTTAC	AAACCCAAGCATTTAC
AAACCCATCCATTTCA	AAACCCAAGCATTTCA
AAACCCATCCATTTCG	AAACCCAAGCATTTCG
AAACCCATCCATTTGC	AAACCCAAGCATTTGC
AAACCCATCCATTTGT	AAACCCAAGCATTTGT
AAACCCATCCCAACCC	AAACCCAAGCCAACCC
AAACCCATCCCAACTC	AAACCCAAGCCAACTC
AAACCCATCCCAAGCA	AAACCCAAGCCAAGCA
AAACCCATCCCAAGCG	AAACCCAAGCCAAGCG
AAACCCATCCCAAGGT	AAACCCAAGCCAAGGT
AAACCCATCCCAAGTA	AAACCCAAGCCAAGTA
AAACCCATCCCAAGTG	AAACCCAAGCCAAGTG
AAACCCATCCCAATAG	AAACCCAAGCCAATAG
AAACCCATCCCACAAG	AAACCCAAGCCACAAG
AAACCCATCCCACAGG	AAACCCAAGCCACAGG
AAACCCATCCCACCGT	AAACCCAAGCCACCGT
AAACCCATCCCACTCG	AAACCCAAGCCACTCG
AAACCCATCCCAGACA	AAACCCAAGCCAGACA
AAACCCATCCCAGAGT	AAACCCAAGCCAGAGT
AAACCCATCCCAGCGA	AAACCCAAGCCAGCGA
AAACCCATCCCAGGAC	AAACCCAAGCCAGGAC
AAACCCATCCCAGGCA	AAACCCAAGCCAGGCA
AAACCCATCCCAGTAG	AAACCCAAGCCAGTAG
AAACCCATCCCAGTGG	AAACCCAAGCCAGTGG
AAACCCATCCCATAAG	AAACCCAAGCCATAAG
AAACCCATCCCATACC	AAACCCAAGCCATACC
AAACCCATCCCATAGA	AAACCCAAGCCATAGA
AAACCCATCCCATATC	AAACCCAAGCCATATC
AAACCCATCCCATCCG	AAACCCAAGCCATCCG
AAACCCATCCCATGCC	AAACCCAAGCCATGCC
AAACCCATCCCATGGG	AAACCCAAGCCATGGG
AAACCCATCCCATTCA	AAACCCAAGCCATTCA
AAACCCATCCCATTCG	AAACCCAAGCCATTCG
AAACCCATCCCATTGT	AAACCCAAGCCATTGT
AAACCCATCCCATTTA	AAACCCAAGCCATTTA
AAACCCATCCCATTTG	AAACCCAAGCCATTTG
AAACCCATCCCGAAAT	AAACCCAAGCCGAAAT
AAACCCATCCCGAACA	AAACCCAAGCCGAACA
AAACCCATCCCGAACG	AAACCCAAGCCGAACG
AAACCCATCCCGAATA	AAACCCAAGCCGAATA
AAACCCATCCCGAATG	AAACCCAAGCCGAATG
AAACCCATCCCGAGAC	AAACCCAAGCCGAGAC
AAACCCATCCCGAGGT	AAACCCAAGCCGAGGT
AAACCCATCCCGAGTG	AAACCCAAGCCGAGTG
AAACCCATCCCGATAG	AAACCCAAGCCGATAG
AAACCCATCCCGATCC	AAACCCAAGCCGATCC
AAACCCATCCCGATCT	AAACCCAAGCCGATCT
AAACCCATCCCGATTT	AAACCCAAGCCGATTT
AAACCCATCCCGCACT	AAACCCAAGCCGCACT
AAACCCATCCCGCTTG	AAACCCAAGCCGCTTG
AAACCCATCCCGGAAT	AAACCCAAGCCGGAAT
AAACCCATCCCGGATA	AAACCCAAGCCGGATA
AAACCCATCCCGGTAG	AAACCCAAGCCGGTAG
AAACCCATCCCGTAAA	AAACCCAAGCCGTAAA
AAACCCATCCCGTAAG	AAACCCAAGCCGTAAG
AAACCCATCCCGTCGT	AAACCCAAGCCGTCGT
AAACCCATCCCGTGAG	AAACCCAAGCCGTGAG
AAACCCATCCCGTGTT	AAACCCAAGCCGTGTT
AAACCCATCCCGTTAT	AAACCCAAGCCGTTAT
AAACCCATCCCGTTCA	AAACCCAAGCCGTTCA
AAACCCATCCCGTTGC	AAACCCAAGCCGTTGC
AAACCCATCCCGTTGT	AAACCCAAGCCGTTGT
AAACCCATCCCTAACT	AAACCCAAGCCTAACT
AAACCCATCCCTAGGA	AAACCCAAGCCTAGGA
AAACCCATCCCTAGGG	AAACCCAAGCCTAGGG
AAACCCATCCCTATCA	AAACCCAAGCCTATCA
AAACCCATCCCTATTA	AAACCCAAGCCTATTA
AAACCCATCCCTATTG	AAACCCAAGCCTATTG
AAACCCATCCCTCAAC	AAACCCAAGCCTCAAC
AAACCCATCCCTCAAT	AAACCCAAGCCTCAAT
AAACCCATCCCTCACG	AAACCCAAGCCTCACG
AAACCCATCCCTCAGC	AAACCCAAGCCTCAGC
AAACCCATCCCTCATA	AAACCCAAGCCTCATA
AAACCCATCCCTCATG	AAACCCAAGCCTCATG
AAACCCATCCCTCCAG	AAACCCAAGCCTCCAG
AAACCCATCCCTCGAT	AAACCCAAGCCTCGAT
AAACCCATCCCTCGTA	AAACCCAAGCCTCGTA
AAACCCATCCCTCGTG	AAACCCAAGCCTCGTG
AAACCCATCCCTCTAG	AAACCCAAGCCTCTAG
AAACCCATCCCTCTCC	AAACCCAAGCCTCTCC
AAACCCATCCCTCTCT	AAACCCAAGCCTCTCT
AAACCCATCCCTCTGG	AAACCCAAGCCTCTGG
AAACCCATCCCTCTTC	AAACCCAAGCCTCTTC
AAACCCATCCCTCTTT	AAACCCAAGCCTCTTT
AAACCCATCCCTGAAG	AAACCCAAGCCTGAAG
AAACCCATCCCTGACC	AAACCCAAGCCTGACC
AAACCCATCCCTGAGA	AAACCCAAGCCTGAGA
AAACCCATCCCTGCCA	AAACCCAAGCCTGCCA
AAACCCATCCCTGGAA	AAACCCAAGCCTGGAA
AAACCCATCCCTGGTT	AAACCCAAGCCTGGTT
AAACCCATCCCTGTCG	AAACCCAAGCCTGTCG
AAACCCATCCCTGTGC	AAACCCAAGCCTGTGC
AAACCCATCCCTGTTG	AAACCCAAGCCTGTTG
AAACCCATCCCTTCCC	AAACCCAAGCCTTCCC
AAACCCATCCCTTCTC	AAACCCAAGCCTTCTC
AAACCCATCCCTTGAT	AAACCCAAGCCTTGAT
AAACCCATCCCTTGGT	AAACCCAAGCCTTGGT
AAACCCATCCCTTGTG	AAACCCAAGCCTTGTG
AAACCCATCCCTTTCC	AAACCCAAGCCTTTCC
AAACCCATCCCTTTGA	AAACCCAAGCCTTTGA
AAACCCATCCCTTTGG	AAACCCAAGCCTTTGG
AAACCCATCCGAAACC	AAACCCAAGCGAAACC
AAACCCATCCGAAATC	AAACCCAAGCGAAATC
AAACCCATCCGAACGC	AAACCCAAGCGAACGC
AAACCCATCCGAACTG	AAACCCAAGCGAACTG
AAACCCATCCGAAGGA	AAACCCAAGCGAAGGA
AAACCCATCCGAATGC	AAACCCAAGCGAATGC
AAACCCATCCGACAGC	AAACCCAAGCGACAGC
AAACCCATCCGACAGT	AAACCCAAGCGACAGT
AAACCCATCCGACATA	AAACCCAAGCGACATA
AAACCCATCCGACATG	AAACCCAAGCGACATG
AAACCCATCCGACCCT	AAACCCAAGCGACCCT
AAACCCATCCGACGGT	AAACCCAAGCGACGGT
AAACCCATCCGACTAG	AAACCCAAGCGACTAG
AAACCCATCCGACTGA	AAACCCAAGCGACTGA
AAACCCATCCGACTTT	AAACCCAAGCGACTTT
AAACCCATCCGAGAAA	AAACCCAAGCGAGAAA
AAACCCATCCGAGAAG	AAACCCAAGCGAGAAG
AAACCCATCCGAGATT	AAACCCAAGCGAGATT
AAACCCATCCGAGCTG	AAACCCAAGCGAGCTG
AAACCCATCCGAGGAG	AAACCCAAGCGAGGAG
AAACCCATCCGAGGCT	AAACCCAAGCGAGGCT
AAACCCATCCGAGTAC	AAACCCAAGCGAGTAC
AAACCCATCCGAGTCA	AAACCCAAGCGAGTCA
AAACCCATCCGAGTGC	AAACCCAAGCGAGTGC
AAACCCATCCGATAAC	AAACCCAAGCGATAAC
AAACCCATCCGATAGT	AAACCCAAGCGATAGT
AAACCCATCCGATCGA	AAACCCAAGCGATCGA
AAACCCATCCGATCGG	AAACCCAAGCGATCGG
AAACCCATCCGATCTC	AAACCCAAGCGATCTC
AAACCCATCCGATGAC	AAACCCAAGCGATGAC
AAACCCATCCGATGCA	AAACCCAAGCGATGCA
AAACCCATCCGATGCG	AAACCCAAGCGATGCG
AAACCCATCCGATGGT	AAACCCAAGCGATGGT
AAACCCATCCGATGTA	AAACCCAAGCGATGTA
AAACCCATCCGATTAG	AAACCCAAGCGATTAG
AAACCCATCCGATTCT	AAACCCAAGCGATTCT
AAACCCATCCGCAAAT	AAACCCAAGCGCAAAT
AAACCCATCCGCAACG	AAACCCAAGCGCAACG
AAACCCATCCGCAATG	AAACCCAAGCGCAATG
AAACCCATCCGCACAA	AAACCCAAGCGCACAA
AAACCCATCCGCACGA	AAACCCAAGCGCACGA
AAACCCATCCGCACTT	AAACCCAAGCGCACTT
AAACCCATCCGCAGTG	AAACCCAAGCGCAGTG
AAACCCATCCGCATAA	AAACCCAAGCGCATAA
AAACCCATCCGCATCC	AAACCCAAGCGCATCC
AAACCCATCCGCCATC	AAACCCAAGCGCCATC
AAACCCATCCGCCCAT	AAACCCAAGCGCCCAT
AAACCCATCCGCCGTT	AAACCCAAGCGCCGTT
AAACCCATCCGCCTAC	AAACCCAAGCGCCTAC
AAACCCATCCGCCTAT	AAACCCAAGCGCCTAT
AAACCCATCCGCCTCA	AAACCCAAGCGCCTCA
AAACCCATCCGCCTTG	AAACCCAAGCGCCTTG
AAACCCATCCGCGAGT	AAACCCAAGCGCGAGT
AAACCCATCCGCGATG	AAACCCAAGCGCGATG
AAACCCATCCGCGGAT	AAACCCAAGCGCGGAT
AAACCCATCCGCGTTC	AAACCCAAGCGCGTTC
AAACCCATCCGCTAGG	AAACCCAAGCGCTAGG
AAACCCATCCGCTGAA	AAACCCAAGCGCTGAA
AAACCCATCCGCTGCT	AAACCCAAGCGCTGCT
AAACCCATCCGCTGTT	AAACCCAAGCGCTGTT
AAACCCATCCGCTTAC	AAACCCAAGCGCTTAC
AAACCCATCCGCTTCG	AAACCCAAGCGCTTCG
AAACCCATCCGGACAT	AAACCCAAGCGGACAT
AAACCCATCCGGACGT	AAACCCAAGCGGACGT
AAACCCATCCGGACTG	AAACCCAAGCGGACTG
AAACCCATCCGGATCA	AAACCCAAGCGGATCA
AAACCCATCCGGCAAC	AAACCCAAGCGGCAAC
AAACCCATCCGGCAGT	AAACCCAAGCGGCAGT
AAACCCATCCGGCTCT	AAACCCAAGCGGCTCT
AAACCCATCCGGCTTT	AAACCCAAGCGGCTTT
AAACCCATCCGGGACT	AAACCCAAGCGGGACT
AAACCCATCCGGGTAT	AAACCCAAGCGGGTAT
AAACCCATCCGGGTTA	AAACCCAAGCGGGTTA
AAACCCATCCGGTAAC	AAACCCAAGCGGTAAC
AAACCCATCCGGTAAT	AAACCCAAGCGGTAAT
AAACCCATCCGGTAGC	AAACCCAAGCGGTAGC
AAACCCATCCGGTAGT	AAACCCAAGCGGTAGT
AAACCCATCCGGTATG	AAACCCAAGCGGTATG
AAACCCATCCGGTTCT	AAACCCAAGCGGTTCT
AAACCCATCCGTAATG	AAACCCAAGCGTAATG
AAACCCATCCGTACAG	AAACCCAAGCGTACAG
AAACCCATCCGTACGG	AAACCCAAGCGTACGG
AAACCCATCCGTAGGC	AAACCCAAGCGTAGGC
AAACCCATCCGTAGTA	AAACCCAAGCGTAGTA
AAACCCATCCGTATAA	AAACCCAAGCGTATAA
AAACCCATCCGTATAG	AAACCCAAGCGTATAG
AAACCCATCCGTATGA	AAACCCAAGCGTATGA
AAACCCATCCGTATGG	AAACCCAAGCGTATGG
AAACCCATCCGTCAAA	AAACCCAAGCGTCAAA
AAACCCATCCGTCAAG	AAACCCAAGCGTCAAG
AAACCCATCCGTCACT	AAACCCAAGCGTCACT
AAACCCATCCGTCAGA	AAACCCAAGCGTCAGA
AAACCCATCCGTCCTA	AAACCCAAGCGTCCTA
AAACCCATCCGTCGAA	AAACCCAAGCGTCGAA
AAACCCATCCGTCTCG	AAACCCAAGCGTCTCG
AAACCCATCCGTCTGC	AAACCCAAGCGTCTGC
AAACCCATCCGTGAAC	AAACCCAAGCGTGAAC
AAACCCATCCGTGACG	AAACCCAAGCGTGACG
AAACCCATCCGTGAGT	AAACCCAAGCGTGAGT
AAACCCATCCGTGCCT	AAACCCAAGCGTGCCT
AAACCCATCCGTGCGA	AAACCCAAGCGTGCGA
AAACCCATCCGTGCTC	AAACCCAAGCGTGCTC
AAACCCATCCGTGGCA	AAACCCAAGCGTGGCA
AAACCCATCCGTGGGT	AAACCCAAGCGTGGGT
AAACCCATCCGTGGTG	AAACCCAAGCGTGGTG
AAACCCATCCGTGTAA	AAACCCAAGCGTGTAA
AAACCCATCCGTGTCC	AAACCCAAGCGTGTCC
AAACCCATCCGTGTCT	AAACCCAAGCGTGTCT
AAACCCATCCGTGTGG	AAACCCAAGCGTGTGG
AAACCCATCCGTGTTT	AAACCCAAGCGTGTTT
AAACCCATCCGTTACT	AAACCCAAGCGTTACT
AAACCCATCCGTTAGG	AAACCCAAGCGTTAGG
AAACCCATCCGTTCAT	AAACCCAAGCGTTCAT
AAACCCATCCGTTCCG	AAACCCAAGCGTTCCG
AAACCCATCCGTTGAA	AAACCCAAGCGTTGAA
AAACCCATCCGTTGGG	AAACCCAAGCGTTGGG
AAACCCATCCGTTGTT	AAACCCAAGCGTTGTT
AAACCCATCCGTTTCG	AAACCCAAGCGTTTCG
AAACCCATCCTAAACA	AAACCCAAGCTAAACA
AAACCCATCCTAAACG	AAACCCAAGCTAAACG
AAACCCATCCTAAATG	AAACCCAAGCTAAATG
AAACCCATCCTAACAG	AAACCCAAGCTAACAG
AAACCCATCCTAAGTA	AAACCCAAGCTAAGTA
AAACCCATCCTAAGTG	AAACCCAAGCTAAGTG
AAACCCATCCTAATCC	AAACCCAAGCTAATCC
AAACCCATCCTAATGA	AAACCCAAGCTAATGA
AAACCCATCCTACAAA	AAACCCAAGCTACAAA
AAACCCATCCTACAAG	AAACCCAAGCTACAAG
AAACCCATCCTACACC	AAACCCAAGCTACACC
AAACCCATCCTACCAC	AAACCCAAGCTACCAC
AAACCCATCCTACCGT	AAACCCAAGCTACCGT
AAACCCATCCTACGAA	AAACCCAAGCTACGAA
AAACCCATCCTACGGG	AAACCCAAGCTACGGG
AAACCCATCCTACGTT	AAACCCAAGCTACGTT
AAACCCATCCTACTAC	AAACCCAAGCTACTAC
AAACCCATCCTACTGC	AAACCCAAGCTACTGC
AAACCCATCCTACTGT	AAACCCAAGCTACTGT
AAACCCATCCTAGAAT	AAACCCAAGCTAGAAT
AAACCCATCCTAGAGC	AAACCCAAGCTAGAGC
AAACCCATCCTAGAGT	AAACCCAAGCTAGAGT
AAACCCATCCTAGATA	AAACCCAAGCTAGATA
AAACCCATCCTAGCCC	AAACCCAAGCTAGCCC
AAACCCATCCTAGCCT	AAACCCAAGCTAGCCT
AAACCCATCCTAGCGG	AAACCCAAGCTAGCGG
AAACCCATCCTAGCTC	AAACCCAAGCTAGCTC
AAACCCATCCTAGTTC	AAACCCAAGCTAGTTC
AAACCCATCCTATCCA	AAACCCAAGCTATCCA
AAACCCATCCTATCTG	AAACCCAAGCTATCTG
AAACCCATCCTATGGA	AAACCCAAGCTATGGA
AAACCCATCCTATTGT	AAACCCAAGCTATTGT
AAACCCATCCTATTTG	AAACCCAAGCTATTTG
AAACCCATCCTCACCA	AAACCCAAGCTCACCA
AAACCCATCCTCACGT	AAACCCAAGCTCACGT
AAACCCATCCTCACTA	AAACCCAAGCTCACTA
AAACCCATCCTCACTG	AAACCCAAGCTCACTG
AAACCCATCCTCAGAA	AAACCCAAGCTCAGAA
AAACCCATCCTCAGAG	AAACCCAAGCTCAGAG
AAACCCATCCTCAGGG	AAACCCAAGCTCAGGG
AAACCCATCCTCATAC	AAACCCAAGCTCATAC
AAACCCATCCTCATAT	AAACCCAAGCTCATAT
AAACCCATCCTCCACA	AAACCCAAGCTCCACA
AAACCCATCCTCCACG	AAACCCAAGCTCCACG
AAACCCATCCTCCATA	AAACCCAAGCTCCATA
AAACCCATCCTCCCTT	AAACCCAAGCTCCCTT
AAACCCATCCTCCGAC	AAACCCAAGCTCCGAC
AAACCCATCCTCGAAG	AAACCCAAGCTCGAAG
AAACCCATCCTCGACC	AAACCCAAGCTCGACC
AAACCCATCCTCGATC	AAACCCAAGCTCGATC
AAACCCATCCTCGCAC	AAACCCAAGCTCGCAC
AAACCCATCCTCGCAT	AAACCCAAGCTCGCAT
AAACCCATCCTCGGCT	AAACCCAAGCTCGGCT
AAACCCATCCTCGTGC	AAACCCAAGCTCGTGC
AAACCCATCCTCTAAT	AAACCCAAGCTCTAAT
AAACCCATCCTCTAGC	AAACCCAAGCTCTAGC
AAACCCATCCTCTATG	AAACCCAAGCTCTATG
AAACCCATCCTCTCGA	AAACCCAAGCTCTCGA
AAACCCATCCTCTCTT	AAACCCAAGCTCTCTT
AAACCCATCCTCTGCA	AAACCCAAGCTCTGCA
AAACCCATCCTCTGTA	AAACCCAAGCTCTGTA
AAACCCATCCTCTTCC	AAACCCAAGCTCTTCC
AAACCCATCCTCTTTC	AAACCCAAGCTCTTTC
AAACCCATCCTGAAAT	AAACCCAAGCTGAAAT
AAACCCATCCTGAAGC	AAACCCAAGCTGAAGC
AAACCCATCCTGACAG	AAACCCAAGCTGACAG
AAACCCATCCTGACCC	AAACCCAAGCTGACCC
AAACCCATCCTGACTT	AAACCCAAGCTGACTT
AAACCCATCCTGAGCA	AAACCCAAGCTGAGCA
AAACCCATCCTGAGTG	AAACCCAAGCTGAGTG
AAACCCATCCTGATAG	AAACCCAAGCTGATAG
AAACCCATCCTGCCAC	AAACCCAAGCTGCCAC
AAACCCATCCTGCCAT	AAACCCAAGCTGCCAT
AAACCCATCCTGCCTG	AAACCCAAGCTGCCTG
AAACCCATCCTGCGAA	AAACCCAAGCTGCGAA
AAACCCATCCTGCTAC	AAACCCAAGCTGCTAC
AAACCCATCCTGGAGT	AAACCCAAGCTGGAGT
AAACCCATCCTGGCCT	AAACCCAAGCTGGCCT
AAACCCATCCTGGCTC	AAACCCAAGCTGGCTC
AAACCCATCCTGGCTT	AAACCCAAGCTGGCTT
AAACCCATCCTGGGAC	AAACCCAAGCTGGGAC
AAACCCATCCTGGGTG	AAACCCAAGCTGGGTG
AAACCCATCCTGGTCT	AAACCCAAGCTGGTCT
AAACCCATCCTGGTGA	AAACCCAAGCTGGTGA
AAACCCATCCTGTAAG	AAACCCAAGCTGTAAG
AAACCCATCCTGTACC	AAACCCAAGCTGTACC
AAACCCATCCTGTACT	AAACCCAAGCTGTACT
AAACCCATCCTGTAGA	AAACCCAAGCTGTAGA
AAACCCATCCTGTCCG	AAACCCAAGCTGTCCG
AAACCCATCCTGTGCC	AAACCCAAGCTGTGCC
AAACCCATCCTGTTAC	AAACCCAAGCTGTTAC
AAACCCATCCTGTTAT	AAACCCAAGCTGTTAT
AAACCCATCCTGTTCA	AAACCCAAGCTGTTCA
AAACCCATCCTGTTGC	AAACCCAAGCTGTTGC
AAACCCATCCTTAAGA	AAACCCAAGCTTAAGA
AAACCCATCCTTACCG	AAACCCAAGCTTACCG
AAACCCATCCTTACGT	AAACCCAAGCTTACGT
AAACCCATCCTTAGTC	AAACCCAAGCTTAGTC
AAACCCATCCTTATAC	AAACCCAAGCTTATAC
AAACCCATCCTTATCA	AAACCCAAGCTTATCA
AAACCCATCCTTATGT	AAACCCAAGCTTATGT
AAACCCATCCTTCACG	AAACCCAAGCTTCACG
AAACCCATCCTTCAGC	AAACCCAAGCTTCAGC
AAACCCATCCTTCATG	AAACCCAAGCTTCATG
AAACCCATCCTTCGAC	AAACCCAAGCTTCGAC
AAACCCATCCTTCGTA	AAACCCAAGCTTCGTA
AAACCCATCCTTCTAA	AAACCCAAGCTTCTAA
AAACCCATCCTTCTAG	AAACCCAAGCTTCTAG
AAACCCATCCTTCTGG	AAACCCAAGCTTCTGG
AAACCCATCCTTCTTC	AAACCCAAGCTTCTTC
AAACCCATCCTTGAAG	AAACCCAAGCTTGAAG
AAACCCATCCTTGACC	AAACCCAAGCTTGACC
AAACCCATCCTTGGAA	AAACCCAAGCTTGGAA
AAACCCATCCTTGTGT	AAACCCAAGCTTGTGT
AAACCCATCCTTGTTG	AAACCCAAGCTTGTTG
AAACCCATCCTTTAGT	AAACCCAAGCTTTAGT
AAACCCATCCTTTCCC	AAACCCAAGCTTTCCC
AAACCCATCCTTTCTT	AAACCCAAGCTTTCTT
AAACCCATCCTTTGAT	AAACCCAAGCTTTGAT
AAACCCATCCTTTGTG	AAACCCAAGCTTTGTG
AAACCCATCGAAACAA	AAACCCAAGGAAACAA
AAACCCATCGAAACGA	AAACCCAAGGAAACGA
AAACCCATCGAAAGAC	AAACCCAAGGAAAGAC
AAACCCATCGAAAGGT	AAACCCAAGGAAAGGT
AAACCCATCGAAAGTG	AAACCCAAGGAAAGTG
AAACCCATCGAAATCC	AAACCCAAGGAAATCC
AAACCCATCGAACACT	AAACCCAAGGAACACT
AAACCCATCGAACATT	AAACCCAAGGAACATT
AAACCCATCGAACCAT	AAACCCAAGGAACCAT
AAACCCATCGAACCTA	AAACCCAAGGAACCTA
AAACCCATCGAACGAA	AAACCCAAGGAACGAA
AAACCCATCGAACGCC	AAACCCAAGGAACGCC
AAACCCATCGAACGCT	AAACCCAAGGAACGCT
AAACCCATCGAACGGA	AAACCCAAGGAACGGA
AAACCCATCGAACGTC	AAACCCAAGGAACGTC
AAACCCATCGAACTAT	AAACCCAAGGAACTAT
AAACCCATCGAACTCA	AAACCCAAGGAACTCA
AAACCCATCGAACTCG	AAACCCAAGGAACTCG
AAACCCATCGAAGAAC	AAACCCAAGGAAGAAC
AAACCCATCGAAGAAT	AAACCCAAGGAAGAAT
AAACCCATCGAAGCAG	AAACCCAAGGAAGCAG
AAACCCATCGAAGCCC	AAACCCAAGGAAGCCC
AAACCCATCGAAGGAC	AAACCCAAGGAAGGAC
AAACCCATCGAAGTAG	AAACCCAAGGAAGTAG
AAACCCATCGAAGTCC	AAACCCAAGGAAGTCC
AAACCCATCGAAGTGA	AAACCCAAGGAAGTGA
AAACCCATCGAAGTGG	AAACCCAAGGAAGTGG
AAACCCATCGAATCCA	AAACCCAAGGAATCCA
AAACCCATCGAATCGC	AAACCCAAGGAATCGC
AAACCCATCGAATGCT	AAACCCAAGGAATGCT
AAACCCATCGAATGTT	AAACCCAAGGAATGTT
AAACCCATCGAATTAC	AAACCCAAGGAATTAC
AAACCCATCGACAACC	AAACCCAAGGACAACC
AAACCCATCGACAAGA	AAACCCAAGGACAAGA
AAACCCATCGACACCG	AAACCCAAGGACACCG
AAACCCATCGACACTA	AAACCCAAGGACACTA
AAACCCATCGACACTG	AAACCCAAGGACACTG
AAACCCATCGACAGCT	AAACCCAAGGACAGCT
AAACCCATCGACAGTC	AAACCCAAGGACAGTC
AAACCCATCGACATAC	AAACCCAAGGACATAC
AAACCCATCGACATCA	AAACCCAAGGACATCA
AAACCCATCGACATCG	AAACCCAAGGACATCG
AAACCCATCGACATTG	AAACCCAAGGACATTG
